aa	ぁ
as	ぃ
ad	ぅ
af	ぇ
ag	ぉ
ah	お
aj	え
ak	う
al	い
a;	あ
A;	亜
aq	ぁい
aw	ぃい
ae	ぅう
ar	ぇい
at	ぉう
ay	おう
au	えい
Au	英
ai	うう
ao	いい
ap	あい
Ap	愛
az	ぁん
ax	ぃん
ac	ぅん
av	ぇん
ab	ぉん
an	おん
An	御
am	えん
Am	円
a,	うん
A,	運
a.	いん
A.	印
a/	あん
A/	案
sa	が
Sa	我
ss	ぎ
Ss	偽
sd	ぐ
Sd	具
sf	げ
Sf	下
sg	ご
Sg	後
sh	こ
Sh	個
sj	け
Sj	ヶ
sk	く
Sk	区
sl	き
Sl	期
s;	か
S;	可
sq	がい
Sq	外
sw	ぎい
se	ぐう
Se	宮
sr	げい
Sr	芸
st	ごう
St	号
sy	こう
Sy	甲
su	けい
Su	計
si	くう
Si	空
so	きい
sp	かい
Sp	階
sz	がん
sx	ぎん
Sx	銀
sc	ぐん
Sc	郡
sv	げん
Sv	現
sb	ごん
sn	こん
Sn	婚
sm	けん
Sm	件
s,	くん
S,	君
s.	きん
S.	金
s/	かん
S/	間
wa	ぎゃ
ws	ぎ
wd	ぎゅ
wf	ぎぇ
wg	ぎょ
Wg	魚
wh	きょ
Wh	許
wj	きぇ
wk	きゅ
wl	き
w;	きゃ
wq	ぎゃい
ww	ぎい
we	ぎゅう
We	牛
wr	ぎぇい
wt	ぎょう
Wt	行
wy	きょう
Wu	強
wu	きぇい
wi	きゅう
Wi	級
wo	きい
wp	きゃい
wz	ぎゃん
wx	ぎん
wc	ぎゅん
wv	ぎぇん
wb	ぎょん
wn	きょん
wm	きぇん
w,	きゅん
w.	きん
w/	きゃん
xa	っが
xs	っぎ
xd	っぐ
xf	っげ
xg	っご
xh	っこ
xj	っけ
xk	っく
xl	っき
x;	っか
xq	っがい
xw	っぎい
xe	っぐう
xr	っげい
xt	っごう
xy	っこう
xu	っけい
xi	っくう
xo	っきい
xp	っかい
xz	っがん
xx	っぎん
xc	っぐん
xv	っげん
xb	っごん
xn	っこん
xm	っけん
x,	っくん
x.	っきん
x/	っかん
da	ざ
Da	座
ds	じ
Ds	時
dd	ず
Dd	図
df	ぜ
Df	是
dg	ぞ
dh	そ
dj	せ
dk	す
Dk	酢
dl	し
Dl	氏
d;	さ
D;	差
dq	ざい
Dq	罪
dw	じい
de	ずう
dr	ぜい
Dr	税
dt	ぞう
Dt	増
dy	そう
Dt	総
du	せい
Du	生
di	すう
Di	数
do	しい
dp	さい
Dp	才
dz	ざん
Dz	残
dx	じん
Dx	人
dc	ずん
dv	ぜん
Dv	前
db	ぞん
Db	損
dn	そん
Dn	村
dm	せん
d,	すん
d.	しん
d/	さん
ea	じゃ
es	じ
ed	じゅ
ef	じぇ
eg	じょ
eh	しょ
Eh	書
ej	しぇ
ek	しゅ
el	し
e;	しゃ
E;	社
eq	じゃい
ew	じい
ee	じゅう
er	じぇい
et	じょう
Et	上
ey	しょう
Ey	証
eu	しぇい
Eu	性
ei	しゅう
Ei	州
eo	しい
ep	しゃい
ez	じゃん
ex	じん
ec	じゅん
ev	じぇん
eb	じょん
en	しょん
em	しぇん
e,	しゅん
e.	しん
e/	しゃん
ca	っざ
cs	っじ
cd	っず
cf	っぜ
cg	っぞ
ch	っそ
cj	っせ
ck	っす
cl	っし
c;	っさ
cq	っざい
cw	っじい
ce	っずう
cr	っぜい
ct	っぞう
cy	っそう
cu	っせい
ci	っすう
co	っしい
cp	っさい
cz	っざん
cx	っじん
cc	っずん
cv	っぜん
cb	っぞん
cn	っそん
cm	っせん
c,	っすん
c.	っしん
c/	っさん
fa	だ
fs	ぢ
fd	づ
ff	で
fg	ど
Fg	度
fh	と
fj	て
fk	つ
fl	ち
f;	た
fq	だい
Fq	第
fw	ぢい
fe	づう
fr	でい
ft	どう
Ft	同
fy	とう
Fy	等
fu	てい
fi	つう
Fi	通
fo	ちい
fp	たい
fz	だん
fx	ぢん
fc	づん
fv	でん
fb	どん
fn	とん
fm	てん
Fm	点
f,	つん
f.	ちん
f/	たん
ra	ぢゃ
rs	でぃ
rd	でゅ
Rd	どぅ
rf	ぢぇ
rg	ぢょ
rh	ちょ
rj	ちぇ
rk	ちゅ
Rk	とぅ
rl	てぃ
r;	ちゃ
rq	ぢゃい
rw	でぃい
re	でゅう
Re	どぅう
rr	ぢぇい
rt	ぢょう
ry	ちょう
ru	ちぇい
ri	ちゅう
Ri	中
ro	てぃい
rp	ちゃい
rz	ぢゃん
rx	でぃん
rc	でゅん
Rc	どぅん
rv	ぢぇん
rb	ぢょん
rn	ちょん
rm	ちぇん
r,	ちゅん
R,	とぅん
r.	てぃん
r/	ちゃん
va	っだ
vs	っぢ
vd	っづ
vf	っで
vg	っど
vh	っと
vj	って
vk	っつ
vl	っち
v;	った
vq	っだい
vw	っぢい
ve	っづう
vr	っでい
vt	っどう
vy	っとう
vu	ってい
vi	っつう
vo	っちい
vp	ったい
vz	っだん
vx	っぢん
vc	っづん
vv	っでん
vb	っどん
vn	っとん
vm	ってん
v,	っつん
v.	っちん
v/	ったん
hk	っ
h;	ゎ
hg	を
hf	ゑ
hd	ん
hs	ゐ
ha	わ
ht	をう
hr	ゑい
he	んう
hw	ゐい
hq	わい
hb	をん
hv	ゑん
hc	んん
hx	ゐん
hz	わん
y;	う゛ぁ
yl	う゛ぃ
yk	う゛
yj	う゛ぇ
yh	う゛ぉ
yp	う゛ぁい
yo	う゛ぃい
yi	う゛う
yi	う゛ぇい
yu	う゛ぉう
y/	う゛ぁん
y.	う゛ぃん
y,	う゛ん
ym	う゛ぇん
yn	う゛ぉん
g;	や
gk	ゆ
gh	よ
gg	ょ
gd	ゅ
ga	ゃ
gp	やい
gi	ゆう
gy	よう
Gy	要
gt	ょう
ge	ゅう
gq	ゃい
g/	やん
g,	ゆん
gn	よん
gb	ょん
gc	ゅん
gz	ゃん
ja	な
js	に
jd	ぬ
jf	ね
jg	の
jh	「
jj	」
jk	、
jl	。
j;	ー
jq	ない
Jq	内
jw	にい
je	ぬう
jr	ねい
jt	のう
jy	『
ju	』
ji	！
jo	？
jz	なん
jx	にん
jc	ぬん
jv	ねん
Jv	年
jb	のん
jn	“
jm	”
j,	，
j.	．
ua	にゃ
us	に
ud	にゅ
uf	にぇ
ug	にょ
uq	にゃい
uw	にい
ue	にゅう
ur	にぇい
ut	にょう
uz	にゃん
ux	にん
uc	にゅん
uv	にぇん
ub	にょん
ka	は
ks	ひ
kd	ふ
Kd	付
kf	へ
kg	ほ
kh	ぼ
kj	べ
kk	ぶ
Kk	部
kl	び
k;	ば
kq	はい
kw	ひい
ke	ふう
kr	へい
kt	ほう
ky	ぼう
ku	べい
Ku	米
ki	ぶう
ko	びい
kp	ばい
Kp	倍
kz	はん
Kz	半
kx	ひん
kc	ふん
Kc	分
kv	へん
kb	ほん
Kb	本
kn	ぼん
km	べん
k,	ぶん
K,	文
k.	びん
k/	ばん
K/	番
ia	ひゃ
is	ひ
id	ひゅ
if	ひぇ
ig	ひょ
ih	びょ
ij	びぇ
ik	びゅ
il	び
i;	びゃ
iq	ひゃい
iw	ひい
ie	ひゅう
ir	ひぇい
it	ひょう
iy	びょう
iu	びぇい
ii	びゅう
io	びい
ip	びゃい
iz	ひゃん
ix	ひん
ic	ひゅん
iv	ひぇん
ib	ひょん
in	びょん
im	びぇん
i,	びゅん
i.	びん
i/	びゃん
,a	っは
,s	っひ
,d	っふ
,f	っへ
,g	っほ
,h	っぼ
,j	っべ
,k	っぶ
,l	っび
,;	っば
,q	っはい
,w	っひい
,e	っふう
,r	っへい
,t	っほう
,y	っぼう
,u	っべい
,i	っぶう
,o	っびい
,p	っばい
,z	っはん
,x	っひん
,c	っふん
,v	っへん
,b	っほん
,n	っぼん
,m	っべん
,,	っぶん
,.	っびん
,/	っばん
la	ま
ls	み
Ls	未
ld	む
lf	め
lg	も
lh	ぽ
lj	ぺ
lk	ぷ
ll	ぴ
Ll	日
l;	ぱ
lq	まい
Lq	枚
lw	みい
le	むう
lr	めい
Lr	名
lt	もう
ly	ぽう
lu	ぺい
li	ぷう
lo	ぴい
lp	ぱい
lz	まん
Lz	万
lx	みん
lc	むん
lv	めん
lb	もん
ln	ぽん
lm	ぺん
l,	ぷん
l.	ぴん
l/	ぱん
oa	みゃ
os	み
od	みゅ
of	みぇ
og	みょ
oh	ぴょ
oj	ぴぇ
ok	ぴゅ
ol	ぴ
o;	ぴゃ
oq	みゃい
ow	みい
oe	みゅう
or	みぇい
ot	みょう
oy	ぴょう
ou	ぴぇい
oi	ぴゅう
oo	ぴい
op	ぴゃい
oz	みゃん
ox	みん
oc	みゅん
ov	みぇん
ob	みょん
on	ぴょん
om	ぴぇん
o,	ぴゅん
o.	ぴん
o/	ぴゃん
.h	っぽ
.j	っぺ
.k	っぷ
.l	っぴ
.;	っぱ
.y	っぽう
.u	っぺい
.i	っぷう
.o	っぴい
.p	っぱい
.n	っぽん
.m	っぺん
.,	っぷん
..	っぴん
./	っぱん
;a	ら
;s	り
;d	る
;f	れ
;g	ろ
;q	らい
;w	りい
;e	るう
;r	れい
;t	ろう
;z	らん
+z	欄
;x	りん
;c	るん
;v	れん
;b	ろん
pa	りゃ
ps	り
pd	りゅ
pf	りぇ
pg	りょ
ph	ふぉ
pj	ふぇ
pk	ふ
pl	ふぃ
p;	ふぁ
pq	りゃい
pw	りい
pe	りゅう
pr	りぇい
pt	りょう
Pt	両
py	ふぉう
pu	ふぇい
pi	ふう
po	ふぃい
pp	ふぁい
pz	りゃん
px	りん
pc	りゅん
pv	りぇん
pb	りょん
pn	ふぉん
pm	ふぇん
p,	ふん
p.	ふぃん
p/	ふぁん
yz	うぁ
ys	うぃ
yx	うぃん
yf	うぇ
yr	うぇい
yv	うぇん
ug	うぉ
ub	うぉん
qj	いぇ
qu	いぇい
qm	いぇん
t;	つぁ
tl	つぃ
tj	つぇ
th	つぉ
tp	つぁい
to	つぃい
tu	つぇい
ty	つぉう
t/	つぁん
t.	つぃん
tm	つぇん
tn	つぉん
s0	十
s1	一
s2	二
s3	三
s4	四
s5	五
s6	六
s7	七
s8	八
s9	九
l0	⑩
l1	①
l2	②
l3	③
l4	④
l5	⑤
l6	⑥
l7	⑦
l8	⑧
l9	⑨
p0	（１０）
p1	（１）
p2	（２）
p3	（３）
p4	（４）
p5	（５）
p6	（６）
p7	（７）
p8	（８）
p9	（９）
;0	Ⅹ
;1	Ⅰ
;2	Ⅱ
;3	Ⅲ
;4	Ⅳ
;5	Ⅴ
;6	Ⅵ
;7	Ⅶ
;8	Ⅷ
;9	Ⅸ
jp	〜
j/	—
hi	；
ho	：
hh	（
hj	）
hy	【
hu	】
hn	〈
hm	〉
h.	…
h/	・
h,	‥
DL	様
FJ	殿
LJ	者
LD	頁
GF	私
KF	物
SS	各
AS	億
AF	宛
HK	〒
S+	頃
Qf	乙
KD	平成
EG	昭和
SE  会社
